wwwwwwwwwwwwwwwwwwww
w111111111111w22222w
w111111111111o2h222w
w111111111111w22h22w
w111111111111wwwowww
w111111111111111111w
w111111111111111s11w
w111111111111111111w
w111111111111111111w
w111111111111111111w
w111111111111111111w
w111111111111111111w
w111111111111111111w
w111111111111111111w
w111111111111111111w
w111111111111111111w
w3wwwowww1111111111w
w3333333w1111111111w
w3333333o1111111111w
w3333333w1111111111w
w3333333w1111111111w
wwwwwwwwwwwwwwwwwwww