wwwwwwwwwwwwwwwwwwww
w            w     w
w            o     w
w            w     w
w            wwwowww
w                  w
w                  w
w                  w
w                  w
w                  w
w                  w
w                  w
w                  w
w                  w
w                  w
w                  w
w wwwowww          w
w       w          w
w      ho   s      w
w       w          w
w       w          w
wwwwwwwwwwwwwwwwwwww