wwwwwwwwwwwwwwwwwwww
w111111111111w22222w
w111111111111o22222w
w111111111111w22222w
w111111111111wwwowww
w111111111111111111w
w111111111111111111w
w111111111111111111w
w111111111111111111w
w111111111111111111w
w111111111111111111w
w1111111h1111111111w
w111111111111111111w
w1111h11111s1111111w
w111111111111111111w
w111111111111111111w
w3wwwowww1111111111w
w3333333w1111111111w
w3333333o1111111111w
w3333333w1111111111w
w3333333w1111111111w
wwwwwwwwwwwwwwwwwwww