wwwwwwwwwwwwwwwwwwww
w              w   w
w             www  w
w   w              w
w   w         www ww
wwwww           w  w
w            wwwwwww
w               w  w
w                  w
w                  w
w                  w
w                  w
w                  w
w                  w
w                  w
w                  w
w                  w
w                  w
w                  w
wwwwwwwwwwwwwwwwwwww