wwwwwwwwwwwwwwwwwwww
w111111111111w22222w
w111111111111o22222w
w111111111111w22222w
w111111111111wwwwoww
w111111111111111111w
w111111111111111111w
w111111111111111111w
w111111111111111111w
w111111111111111111w
w111111111111111111w
w111111111111111111w
w111111111111111111w
w1111h11111s1111111w
w111111111111111111w
w111111111111111111w
w11wwowww1111111111w
w3333333w1111111111w
w3333h33o1111111111w
w3333333w1111111111w
w3333333w1111111111w
wwwwwwwwwwwwwwwwwwww